Level 5
WWWWWWWWWWWW
W____EE____W
WX___XX___XW
WX________XW
W__XX__XX__W
W__________W
WX_X_XX_X_XW
WX_________W
W__X_X_X_XXW
WH_________W
WXXXXXXXXXXW