Level 3
WWWWWWWWWWWW
W____EE____W
WX___XX___XW
W__________W
WXX__XXXX__W
W__________W
W__XXXX___XW
W__________W
WX____XXXXXW
WH_________W
WXXXXXXXXXXW