Level 2
WWWWWWWWWWWW
W____EE____W
WXX__XX__XXW
W__________W
W__XXXXXX__W
W__________W
WXXX____XXXW
W__________W
WX_XXXXXX_XW
WH_________W
WXXXXXXXXXXW