Level 4
WWWWWWWWWWWW
W____EE____W
WX___XX___XW
W__________W
WX__XXXX__XW
W__________W
WXXX____XXXW
W__________W
WX___XX___XW
WH_________W
WXXXXXXXXXXW